XX00000XXE
000XXXXXX0
0X0000X000
0X0XX0X0X0
0X0XX000X0
0X0XXXXXXX
0X00000XXX
0XXXXX0XXX
000XX000XX
SXXXX0X0XX